0 00 00 00 00 00 00 00 00 00 00 00 00 00 0
0 -1 -1 -1 00 -1 -1 -1 -1 -1 -1 -1 -1 -1 0
0 -1 -1 -1 00 -1 -1 -1 -1 -1 -1 -1 -1 -1 0
0 -1 -1 -1 00 -1 -1 -1 -1 -1 -1 -1 -1 -1 0
0 -1 -1 -1 -1 -1 -1 -1 -1 -1 -1 -1 -1 -1 0
0 00 -1 -1 -1 -1 -1 -1 -1 -1 -1 -1 -1 -1 0 
0 -1 -1 -1 -1 -1 -1 -1 -1 -1 -1 -1 -1 -1 0 
0 -1 -1 -1 -1 -1 -1 -1 -1 -1 -1 -1 -1 -1 0 
0 -1 -1 -1 -1 -1 -1 -1 -1 -1 -1 -1 -1 -1 0 
0 -1 -1 -1 -1 -1 -1 -1 -1 -1 -1 -1 -1 -1 0 
0 -1 -1 -1 -1 -1 -1 -1 -1 -1 -1 -1 -1 -1 0 
0 00 00 00 00 00 00 00 00 00 00 00 00 00 0