-1 -1 -1 -1 -1 -1 -1 -1 -1 -1 -1
-1 00 00 00 00 00 00 00 00 00 -1
-1 00 -1 -1 -1 00 00 00 -5 00 -1
-1 00 00 00 00 -1 00 00 00 00 -1
-1 00 00 00 -1 -1 -1 00 00 00 -1
-1 00 00 00 -1 00 00 -1 00 00 -1
-1 00 00 00 -1 00 00 -1 00 00 -1 
-1 00 00 00 -1 00 00 -1 00 00 -1
-1 00 -1 -1 -1 00 00 -1 -1 00 -1
-1 00 00 00 00 00 00 00 00 00 -1
-1 00 00 00 00 00 00 00 00 -5 -1
-1 -1 -1 -1 -1 -1 -1 -1 -1 -1 -1
